19 39 1 2 9 16
&&&&&&&&&&&&&&&&&&&&&&&&&&&&&&&&&&&&&&&
& X               &           &       &
&   &&&&&&&&&&&   &   &&&&&       &   &
&   &       &     &   &   &&&&&&&&&   &
&   &   &   &   &&&   &   &   &       &
&   &&&&&   &&&&&&&           &   &&&&&
&           &&&       &&&   &&&   &&&&&
&&&&&&&&&   &&&   &&&&&&&   &&&   &&&&&
&&&&&   &   &&&   &&&   &&&&&&&       &
&       &   &&& O &&&   &&&&&&&&&   &&&
&   &&&&&   &&&&&&&&&   &             &
&           &       &   &&&&&&&&&&&   &
&&&&&   &&&&&&&&&   &   &       &&&   &
&&&&&   &               &&&&&   &&&   &
&       &   &&&&&   &&&&&   &         &
&   &&&&&   &       &       &&&   &   &
&   &&&&&   &   &&&&&   &   &&&   &   &
&           &           &         &   &
&&&&&&&&&&&&&&&&&&&&&&&&&&&&&&&&&&&&&&&
